Department of Theoretical Physics and Center for Astroparticle Physics (CAP),  Université de Genève,  24 quai E. Ansermet, CH-1211, Geneva 4, Switzerland	UNIGE
AEC-LHEP, University of Bern, Bern, Switzerland	UNIBE
Albert Einstein Center for Fundamental Physics and Laboratory for High Energy Physics, University of Bern, Bern, Switzerland	UNIBE
Albert Einstein Center for Fundamental Physics and Laboratory for High EnergyPhysics, University of Bern, Bern, Switzerland	UNIBE
Albert Einstein Center for Fundamental Physics, Bern, Switzerland	UNIBE
Albert Einstein Center for Fundamental Physics, Institut fur Theoretische Physik, Universitat Bern, Sidlerstrasse 5, CH-3012, Bern, Switzerland	UNIBE
Albert Einstein Center for Fundamental Physics, Institut für Theoretische Physik, Universität Bern, Sidlerstrasse 5, 3012, Bern, Switzerland	UNIBE
Albert Einstein Center for Fundamental Physics, Institut für Theoretische Physik, Universität Bern, Sidlerstrasse 5, CH-3012, Bern, Switzerland	UNIBE
Albert Einstein Center for Fundamental Physics, Institut für Theoretische Physik, Universität Bern, Sidlerstraße 5, 3012 , Bern, Switzerland	UNIBE
Albert Einstein Center for Fundamental Physics, Institut für theoretische Physik, Universität Bern, Sidlerstr. 5, 3012 , Bern, Switzerland	UNIBE
Albert Einstein Center for Fundamental Physics, Institut für theoretische Physik, Universität Bern, Sidlerstrasse 5, 3012, Bern, Switzerland	UNIBE
Albert Einstein Center for Fundamental Physics, Institute for Theoretical Physics, Bern University, 3012 Bern, Switzerland	UNIBE
Albert Einstein Center for Fundamental Physics, Institute for Theoretical Physics, Bern University, Bern, 3012, Switzerland	UNIBE
Albert Einstein Center for Fundamental Physics, Institute for Theoretical Physics, Bern University, Sidlerstrasse 5, 3012, Bern, Switzerland	UNIBE
Albert Einstein Center for Fundamental Physics, Institute for Theoretical Physics, Bern University, Sidlerstrasse 5, Bern, CH3012, Switzerland	UNIBE
Albert Einstein Center for Fundamental Physics, Institute for Theoretical Physics, Bern University, Sidlerstrasse 5, CH-3012 Bern, Switzerland	UNIBE
Albert Einstein Center for Fundamental Physics, Institute for Theoretical Physics, Bern University, Sidlerstrasse 5, CH-3012, Bern, Switzerland	UNIBE
Albert Einstein Center for Fundamental Physics, Institute for Theoretical Physics, Bern University, Sidlerstrasse 5, CH3012, Bern, Switzerland	UNIBE
Albert Einstein Center for Fundamental Physics, Institute for Theoretical Physics, Bern University, Sidlerstraße 5, CH-3012 Bern, Switzerland	UNIBE
Albert Einstein Center for Fundamental Physics, Institute for Theoretical Physics, Sidlerstrasse 5, Bern, 3012, Switzerland	UNIBE
Albert Einstein Center for Fundamental Physics, Institute for Theoretical Physics, Sidlerstrasse 5, Bern, CH-3012, Switzerland	UNIBE
Albert Einstein Center for Fundamental Physics, Institute for Theoretical Physics, University of Bern, 5 Sidlestrasse, Bern, CH-3012, Switzerland	UNIBE
Albert Einstein Center for Fundamental Physics, Institute for Theoretical Physics, University of Bern, 5 Sidlestrasse, CH-3012, Bern, Switzerland	UNIBE
Albert Einstein Center for Fundamental Physics, Institute for Theoretical Physics, University of Bern, Bern, Switzerland	UNIBE
Albert Einstein Center for Fundamental Physics, Institute for Theoretical Physics, University of Bern, CH-3012, Bern, Switzerland	UNIBE
Albert Einstein Center for Fundamental Physics, Institute for Theoretical Physics, University of Bern, Sidlerstr. 5, 3012 , Bern, Switzerland	UNIBE
Albert Einstein Center for Fundamental Physics, Institute for Theoretical Physics, University of Bern, Sidlerstrasse 5, 3012, Bern, Switzerland	UNIBE
Albert Einstein Center for Fundamental Physics, Institute for Theoretical Physics, University of Bern, Sidlerstrasse 5, 3012-Bern, Switzerland	UNIBE
Albert Einstein Center for Fundamental Physics, Institute for Theoretical Physics, University of Bern, Sidlerstrasse 5, Bern, CH-3012, Switzerland	UNIBE
Albert Einstein Center for Fundamental Physics, Institute for Theoretical Physics, University of Bern, Sidlerstrasse 5, CH-3012 Bern, Switzerland	UNIBE
Albert Einstein Center for Fundamental Physics, Institute for Theoretical Physics, University of Bern, Sidlerstrasse 5, CH-3012, Bern, Switzerland	UNIBE
Albert Einstein Center for Fundamental Physics, Institute for Theoretical Physics, University of Bern, Sidlestrasse 5, 3012, Bern, Switzerland	UNIBE
Albert Einstein Center for Fundamental Physics, Institute for Theoretical Physics, Universität Bern, Sidlerstrasse 5, Bern, CH-3012, Switzerland	UNIBE
Albert Einstein Center for Fundamental Physics, Institute for TheoreticalPhysics, Bern University, Sidlerstrasse 5, CH-3012 Bern, Switzerland	UNIBE
Albert Einstein Center for Fundamental Physics, Institute for TheoreticalPhysics, University of Bern, Sidlerstrasse 5, 3012 Bern, Switzerland	UNIBE
Albert Einstein Center for Fundamental Physics, Institute for TheoreticalPhysics, University of Bern, Sidlerstrasse 5, 3012-Bern, Switzerland	UNIBE
Albert Einstein Center for Fundamental Physics, Institute for TheoreticalPhysics, University of Bern, Sidlerstrasse 5, CH–3012 Bern, Switzerland	UNIBE
Albert Einstein Center for Fundamental Physics, Laboratory for High Energy Physics (LHEP), University of Bern, 3012 , Bern, Switzerland	UNIBE
Albert Einstein Center for Fundamental Physics, Laboratory for High Energy Physics (LHEP), University of Bern, CH-3012 Bern, Switzerland	UNIBE
Albert Einstein Center for Fundamental Physics, Laboratory for High Energy Physics (LHEP), University of Bern, CH-3012, Bern, Switzerland	UNIBE
Albert Einstein Center for Fundamental Physics, Laboratory for High Energy Physics, University of Bern, Bern, Switzerland	UNIBE
Albert Einstein Center for Fundamental Physics, Laboratory for High EnergyPhysics (LHEP), University of Bern, CH-3012 Bern, Switzerland	UNIBE
Albert Einstein Center for Fundamental Physics, Laboratory of High Energy Physics, Bern, Switzerland	UNIBE
Albert Einstein Center for Fundamental Physics, University of Bern, 3012, Bern, Switzerland	UNIBE
Albert Einstein Center for Fundamental Physics, University of Bern, Bern, Switzerland	UNIBE
Albert Einstein Center for Fundamental Physics, University of Bern, Sidlerstr. 5, 3012 Bern, Switzerland	UNIBE
Albert Einstein Center for Fundamental Physics, University of Bern, Sidlerstrasse 5, 3012, Bern, Switzerland	UNIBE
Albert Einstein Center, Institute for Theoretical Physics Bern University, Sidlerstrasse 5, Bern, CH-3012, Switzerland	UNIBE
Albert Einstein Center, Institute for Theoretical Physics, Bern University, Sidlerstrasse 5, Bern, CH-3012, Switzerland	UNIBE
Also at Section de Physique, Université de Genève, Geneva, Switzerland	UNIGE
Basel University, Switzerland	UNIBA
CERN Theory Division, CH-1211, Geneva 23, Switzerland	CERN
CERN Theory Division, Geneva 23, CH-1211, Switzerland	CERN
CERN, 1211 Geneva 23, Switzerland	CERN
CERN, Geneva, Switzerland	CERN
CERN, Genève 23, CH-1211, Switzerland	CERN
CERN, Physics Department, Geneva 23, 1211, Switzerland	CERN
CERN, Physics Department, TH Unit, CH-1211, Geneva 23, Switzerland	CERN
CERN, Physics Department, TH Unit, Geneva 23, CH-1211, Switzerland	CERN
CERN, Physics Department, Theory Unit, Geneva, Switzerland	CERN
CERN, Switzerland	CERN
DPMC-MaNEP, University of Geneva, 24 Quai Ernest-Ansermet, CH-1211 Geneva, Switzerland	UNIGE
Departement Physik, Universität Basel, Basel, 4056, Switzerland	UNIBA
Departement Physik, Universität Basel, Switzerland	UNIBA
Departement de Physique Theorique, Universite de Geneve, Geneve 4, CH-1211, Switzerland	UNIGE
Departement für Physik, Universität Basel, Basel, 4056, Switzerland	UNIBA
Department Physik, Universität Basel, Basel, 4056, Switzerland	UNIBA
Department of Mathematics, University of Geneva, 2-4 rue du Lièvre, c.p. 64, 1211, Genève 4, Switzerland	UNIGE
Department of Physics, University of Basel,  Klingelbergstr. 82, CH-4056 Basel, Switzerland	UNIBA
Department of Physics, University of Basel,  Klingelbergstrasse 82, CH-4056 Basel, Switzerland	UNIBA
Department of Physics, University of Basel, 4056, Basel, Switzerland	UNIBA
Department of Physics, University of Basel, Basel, 4052, Switzerland	UNIBA
Department of Physics, University of Basel, Basel, CH-4056, Switzerland	UNIBA
Department of Physics, University of Basel, Basel, Ch-4056, Switzerland	UNIBA
Department of Physics, University of Basel, Klingelbergstr. 82,  Basel, CH-4056 Switzerland	UNIBA
Department of Physics, University of Basel, Klingelbergstr. 82, Basel, CH-4056, Switzerland	UNIBA
Department of Physics, University of Basel, Klingelbergstr. 82, CH-4056 Basel, Switzerland	UNIBA
Department of Physics, University of Basel, Klingelbergstr. 82, CH-4056, Basel, Switzerland	UNIBA
Department of Physics, University of Basel, Klingelbergstr. 82, CH-4056 Basel, Switzerland	UNIBA
Department of Physics, University of Fribourg, Fribourg, Switzerland	UNIFR
Department of Physics, University of Zürich, 8057 Zürich, Switzerland	UZH
Department of Physics, University of Zürich, Winterthurerstrasse 190, 8057, Zürich, Switzerland	UZH
Department of Physics, University of Zürich, Winterthurerstrasse 190, CH-8057, Zürich, Switzerland	UZH
Department of Physics, University of Zürich, Winterthurerstrasse 190, Zürich, CH-8057, Switzerland	UZH
Department of Physics, University of Zürich, Zürich, CH-8057, Switzerland	UZH
Department of Theoretical Physics and Center for Astroparticle Physics (CAP), 24 quai E. Ansermet, CH-1211, Geneva 4, Switzerland	UNIGE
Department of Theoretical Physics and Center for Astroparticle Physics (CAP), Université de Genève, 24 quai E. Ansermet, CH-1211, Geneva 4, Switzerland	UNIGE
Department of Theoretical Physics, 24 quai E. Ansermet, Geneva 4, CH-1211, Switzerland	UNIGE
Department of Theoretical Physics, Center for Astroparticle Physics (CAP), 24 quai E. Ansermet, Geneva 4, CH-1211, Switzerland	UNIGE
Département de Physique  Théorique and Center for Astroparticle Physics, Université de Genève, 24 Quai E. Ansermet,   Genève, CH-1211 Switzerland	UNIGE
Département de Physique Nucléaire et Corpusculaire, Université de Genève, 1211 , Geneva, Switzerland	UNIGE
Département de Physique Théorique &amp; Center for Astroparticle Physics, Université de Genève, Quai E. Ansermet 24, 1211, Genève 4, Switzerland	UNIGE
Département de Physique Théorique and Center for Astroparticle Physics, Université de Genève, 24 quai Ansermet, 1211, Geneva 4, Switzerland	UNIGE
Département de Physique Théorique and Center for Astroparticle Physics, Université de Genève, 24 quai Ansermet, CH-1211 Genève 4, Switzerland	UNIGE
Département de Physique Théorique and Center for Astroparticle Physics, Université de Genève, 24 quai Ansermet, CH-1211, Genève 4, Switzerland	UNIGE
Département de Physique Théorique and Center for Astroparticle Physics, Université de Genève, 24 quai Ansermet, CH-1211, Genéve 4, Switzerland	UNIGE
Département de Physique Théorique and Center for Astroparticle Physics, Université de Genève, 24 quai Ansermet, CH–1211 Genève 4, Switzerland	UNIGE
Département de Physique Théorique and Center for Astroparticle Physics, Université de Genève, 24 quai Ernest Ansermet, CH-1211, Genève 4, Switzerland	UNIGE
Département de Physique Théorique and Center for Astroparticle Physics,Université de Genève, 24 quai Ansermet, CH–1211 Genève 4, Switzerland	UNIGE
Département de Physique Théorique and Centre for Astroparticle Physics (CAP),  24 quai E. Ansermet,  Geneva, CH-1211 Switzerland	UNIGE
Département de Physique Théorique and Centre for Astroparticle Physics (CAP), 24 quai E. Ansermet, Geneva, CH-1211, Switzerland	UNIGE
Département de Physique Théorique and Centre for Astroparticle Physics (CAP), Université de Genève, 24 quai Ernest-Ansermet, CH-1211, Geneva 4, Switzerland	UNIGE
Département de Physique Théorique et section de Mathématiques, Université de Genève, Genève, CH-1211 Switzerland	UNIGE
Département de Physique Théorique et section de Mathématiques, Université de Genève, Genève, CH-1211, Switzerland	UNIGE
Département de Physique Théorique, Center for Astroparticle Physics, Université de Genève, 24 quai Ansermet, Genève 4, CH-1211, Switzerland	UNIGE
Département de Physique Théorique, Center for Astroparticle Physics, Université de Genève, 24 quai Ansermet, Genéve 4, CH-1211, Switzerland	UNIGE
Département de Physique Théorique, Université de Genève, Genève, CH-1211, Switzerland	UNIGE
Département de physique nucléaire et corpusculaire, Université de Genève, 1211, Geneva, Switzerland	UNIGE
Département de physique nucléaire et corpusculaire, Université de Genève, 1211 , Geneva, Switzerland	UNIGE
Départment de Physique  Théorique and Center for Astroparticle Physics,  Université de Genève, 24 Quai E. Ansermet, CH-1211  Genève, Switzerland	UNIGE
ETH Zurich, 8093 Zurich, Switzerland	ETHZ
ETH Zurich, CH-8093 Zurich, Switzerland	ETHZ
ETH Zurich, Institute for Particle Physics, CH-8093 Zurich, Switzerland	ETHZ
ETH Zurich, Institute for Particle Physics, Otto-Stern-Weg 5, 8093 Zurich, Switzerland	ETHZ
ETH Zurich, Institute for Particle Physics, Zurich, Switzerland	ETHZ
ETH Zürich, 8092, Zurich, Switzerland	ETHZ
ETH Zürich, Institut für Theoretische Physik, Wolfgang Pauli Strasse 27, 8093 Zürich, Switzerland	ETHZ
ETH Zürich, Institut für Theoretische Physik, Wolfgang Pauli Strasse 27, CH-8093 Zürich, Switzerland	ETHZ
ETH Zürich, Institute for Particle Physics, Zürich, CH-8093, Switzerland	ETHZ
ETH Zürich, Institute for Theoretical Physics, Wolfgang-Pauli-Str. 27, 8093, Zürich, Switzerland	ETHZ
ETH, Zurich, Switzerland	ETHZ
Ecole Polytechnique Fédérale de Lausanne (EPFL), Lausanne, Switzerland	EPFL
European Organization for Nuclear Research (CERN), Geneva, Switzerland	UNIGE
FSB/ITP/LPPC, Ecole Polytechnique Federale de Lausanne, Lausanne, CH-1015, Switzerland	EPFL
IPP, ETHZ, 8093, Zurich, Switzerland	ETHZ
ITP - AEC, University of Bern, Sidlerstrasse 5, 3012, Bern, Switzerland	UNIBE
ITP – AEC, University of Bern, Sidlerstrasse 5, Bern, CH-3012, Switzerland	UNIBE
Institut de Th?orie des Ph?nom?nes Physiques, ?cole Polytechnique F?d?rale de Lausanne, Lausanne, CH-1015 Switzerland	EPFL
Institut de Théorie des Phénomenes Physiques, EPFL, Lausanne, Switzerland	EPFL
Institut de Théorie des Phénomènes Physique, EPFL, CH-1015, Lausanne, Switzerland	EPFL
Institut de Théorie des Phénomènes Physiques, EPFL, 1015 Lausanne, Switzerland	EPFL
Institut de Théorie des Phénomènes Physiques, EPFL, 1015, Lausanne, Switzerland	EPFL
Institut de Théorie des Phénomènes Physiques, EPFL, CH-1015 Lausanne, Switzerland	EPFL
Institut de Théorie des Phénomènes Physiques, EPFL, CH-1015, Lausanne, Switzerland	EPFL
Institut de Théorie des Phénomènes Physiques, EPFL, Lausanne, CH-1015, Switzerland	EPFL
Institut de Théorie des Phénomènes Physiques, EPFL, Lausanne, Switzerland	EPFL
Institut de Théorie des Phénomènes Physiques, EPFL, Rte de la Sorge, 1015, Lausanne, Switzerland	EPFL
Institut de Théorie des Phénomènes Physiques, École Polytechnique Fédérale de Lausanne,  1015 Lausanne, Switzerland	EPFL
Institut de Théorie des Phénomènes Physiques, École Polytechnique Fédérale de Lausanne, 1015 Lausanne, Switzerland	EPFL
Institut de Théorie des Phénomènes Physiques, École Polytechnique Fédérale de Lausanne, CH-1015, Lausanne, Switzerland	EPFL
Institut de Théorie des Phénomènes Physiques, École Polytechnique Fédérale de Lausanne, Lausanne, CH-1015, Switzerland	EPFL
Institut de Théorie des Phénoménes Physiques, École Polytechnique Fédérale de Lausanne, 1015, Lausanne, Switzerland	EPFL
Institut fur Theoretische Physik, ETH Zurich, CH-8093, Zurich, Switzerland	ETHZ
Institut für Mathematik, Universität Zürich, Winterthurerstrasse 190, 8057 Zürich, Switzerland	UZH
Institut für Mathematik, Universität Zürich-Irchel, Winterthurerstrasse 190, CH-8057 Zürich, Switzerland	UZH
Institut für Physik, University of Basel, Basel, CH-4056, Switzerland	UNIBA
Institut für Physik, Universität Basel, Switzerland	UNIBA
Institut für Teilchenphysik, ETH, Zurich, Switzerland	ETHZ
Institut für Teilchenphysik, ETH, Zürich, Switzerland	ETHZ
Institut für Theoretische Physik, ETH Zurich, 8093 Zurich, Switzerland	ETHZ
Institut für Theoretische Physik, ETH Zurich, CH-8093 Zürich, Switzerland	ETHZ
Institut für Theoretische Physik, ETH Zurich, CH-8093, Zürich, Switzerland	ETHZ
Institut für Theoretische Physik, ETH Zurich, Wolfgang-Pauli-Str. 27, CH-8093, Zürich, Switzerland	ETHZ
Institut für Theoretische Physik, ETH Zurich, Wolfgang-Pauli-Str. 27, CH-8093 Zürich, Switzerland	ETHZ
Institut für Theoretische Physik, ETH Zürich, 8093, Zürich, Switzerland	ETHZ
Institut für Theoretische Physik, ETH Zürich, CH-8093 Zürich, Switzerland	ETHZ
Institut für Theoretische Physik, ETH Zürich, CH-8093, Zürich, Switzerland	ETHZ
Institut für Theoretische Physik, ETH Zürich, Wolfgang-Pauli-Strasse 27, Zürich, 8093, Switzerland	ETHZ
Institut für Theoretische Physik, ETH Zürich, Wolfgang-Pauli-Strasse 27, Zürich, CH-8093, Switzerland	ETHZ
Institut für Theoretische Physik, ETH Zürich, Wolfgang-Paulistrasse 27, CH 8093, Zürich, Switzerland	ETHZ
Institut für Theoretische Physik, Eidgenössische Technische Hochschule Zürich, Wolfgang-Pauli-Strasse 27, 8093, Zürich, Switzerland	ETHZ
Institut für Theoretische Physik, Eidgenössische Technische Hochschule Zürich, Wolfgang-Pauli-Strasse 27, Zürich, 8093, Switzerland	ETHZ
Institut für Theoretische Physik, Eidgenössische Technische HochschuleZürich, Wolfgang-Pauli-Strasse 27, 8093 Zürich, Switzerland	ETHZ
Institut für Theoretische Physik, Universität Zürich, 8057 Zürich, Switzerland	UZH
Institut für Theoretische Physik, Universität Zürich, 8057 , Zurich, Switzerland	UZH
Institut für Theoretische Physik, Universität Zürich, CH-8057 Zürich, Switzerland	UZH
Institut für Theoretische Physik, Universität Zürich, Winterthurerstrasse 190, CH-8057 Zürich, Switzerland	UZH
Institut für Theoretische Physik, Universität Zürich, Wintherturerstrasse 190, CH-8057 Zürich, Switzerland	UZH
Institut für Theoretische Physik, Universität Zürich, Wintherturerstrasse 190, Zürich, CH-8057, Switzerland	UZH
Institut für Theoretische Physik, Universität Zürich, Wintherturerstrasse190, CH-8057, Zürich, Switzerland	UZH
Institut für Theoretische Physik, Universität Zürich, Zürich, 8057, Switzerland	UZH
Institut für Theoretische Physik, Universität Zürich, Zürich, CH-8057, Switzerland	UZH
Institut für Theoretische Physik, Universität Zürich, Zürich, Switzerland	UZH
Institute de Théorie des Phénomenès Physiques, École Polytechnique Fédérale de Lausanne, CH-1015, Lausanne, Switzerland	EPFL
Institute for Computational Science, University of Zürich, Winterthurerstrasse 190, Zürich, CH-8057, Switzerland	UZH
Institute for Particle Physics, ETH Zurich, 8093 Zurich, Switzerland	ETHZ
Institute for Particle Physics, ETH Zurich, Zurich, Switzerland	ETHZ
Institute for Particle Physics, ETH Zürich, 8093 , Zurich, Switzerland	ETHZ
Institute for Particle Physics, ETH Zürich, Otto-Stern-Weg 5, CH-8093, Zürich, Switzerland	ETHZ
Institute for Physics, University of Zurich, Winterthurerstr. 190, 8057, Zurich, Switzerland	UZH
Institute for Theoretical Physics,  Albert Einstein Center, University of Bern,   Sidlerstrasse 5, CH-3012 Bern, Switzerland	UNIBE
Institute for Theoretical Physics, AEC, Sidlerstrasse 5, CH-3012, Bern, Switzerland	UNIBE
Institute for Theoretical Physics, Albert Einstein Center for Fundamental Physics, University of Bern, Sidlerstrasse 5, CH-3012, Bern, Switzerland	UNIBE
Institute for Theoretical Physics, Albert Einstein Center, University of Bern,   Sidlerstrasse 5,  Bern, 3012 Switzerland	UNIBE
Institute for Theoretical Physics, Albert Einstein Center, University of Bern,  Sidlerstrasse 5, CH-3012 Bern, Switzerland	UNIBE
Institute for Theoretical Physics, Albert Einstein Center, University of Bern, Sidlerstrasse 5, 3012, Bern, Switzerland	UNIBE
Institute for Theoretical Physics, Albert Einstein Center, University of Bern, Sidlerstrasse 5, CH-3012 Bern, Switzerland	UNIBE
Institute for Theoretical Physics, Albert Einstein Center, University of Bern, Sidlerstrasse 5, CH-3012, Bern, Switzerland	UNIBE
Institute for Theoretical Physics, Albert Einstein Center, University ofBern, Sidlerstrasse 5, 3012 Bern, Switzerland	UNIBE
Institute for Theoretical Physics, ETH Zurich, 8093 Zurich, Switzerland	ETHZ
Institute for Theoretical Physics, ETH Zurich, 8093, Zurich, Switzerland	ETHZ
Institute for Theoretical Physics, ETH Zurich, Wolfgang-Pauli-Str. 27, 8093, Zurich, Switzerland	ETHZ
Institute for Theoretical Physics, ETH Zurich, Zurich, 8093, Switzerland	ETHZ
Institute for Theoretical Physics, ETH Zürich, 8093, Zürich, Switzerland	ETHZ
Institute for Theoretical Physics, ETH Zürich, CH-8093 Zürich, Switzerland	ETHZ
Institute for Theoretical Physics, ETH Zürich, CH-8093, Zürich, Switzerland	ETHZ
Institute for Theoretical Physics, ETH Zürich, Wolfgang-Pauli-Str. 27, Zürich, CH-8093, Switzerland	ETHZ
Institute for Theoretical Physics, ETH Zürich, Wolfgang-Pauli-Strasse 27, 8093, Zürich, Switzerland	ETHZ
Institute for Theoretical Physics, ETH Zürich, Zürich, 8093, Switzerland	ETHZ
Institute for Theoretical Physics, ETH, CH-8093 Zürich, Switzerland	ETHZ
Institute for Theoretical Physics, ETH, CH-8093, Zürich, Switzerland	ETHZ
Institute of Theoretical Physics, EPFL, 1015, Lausanne, Switzerland	EPFL
Institute of Theoretical Physics, EPFL, CH-1015, Lausanne, Switzerland	EPFL
Institute of Theoretical Physics, EPFL, Lausanne, CH-1015, Switzerland	EPFL
Laboratory for High Energy Physics, Albert Einstein Center for Fundamental Physics, University of Bern, 3012, Bern, Switzerland	UNIBE
Laboratory for High Energy Physics, Albert Einstein Center for Fundamental Physics, University of Bern, Bern, Switzerland	UNIBE
Laboratory for High Energy Physics, École Polytechnique Fédérale, 1015 , Lausanne, Switzerland	EPFL
Laboratory of Radiochemistry and Environmental Chemistry, Paul Scherrer Institut, CH-5232, Switzerland	PSI
PH Department, TH Unit, CERN, CH-1211, Geneva 23, Switzerland	CERN
Paul Scherrer Institut (PSI), 5232, Villigen, Switzerland	PSI
Paul Scherrer Institut (PSI), Villigen, Switzerland	PSI
Paul Scherrer Institut, 5232, Villigen PSI, Switzerland	PSI
Paul Scherrer Institut, CH-5232, Villigen PSI, Switzerland	PSI
Paul Scherrer Institut, CH-5232, Villigen, Switzerland	PSI
Paul Scherrer Institut, Villigen PSI, CH-5232, Switzerland	PSI
Paul Scherrer Institut, Villigen, Switzerland	PSI
Paul Scherrer Institute (PSI), Villigen-PSI, CH-5232, Switzerland	PSI
Paul Scherrer Institute, 5232 Villigen, Switzerland	PSI
Paul Scherrer Institute, 5232, Villigen PSI, Switzerland	PSI
Paul Scherrer Institute, CH-5232 Villigen PSI, Switzerland	PSI
Paul Scherrer Institute, CH-5232 Villigen, Switzerland	PSI
Paul Scherrer Institute, CH-5323, Villigen PSI, Switzerland	PSI
Paul Scherrer Institute, Villigen PSI, CH-5232, Switzerland	PSI
Paul Scherrer Institute, Villigen PSI, CH-5323, Switzerland	PSI
Physics Department, University of Fribourg, Fribourg, CH-1700, Switzerland	UNIFR
Physics Institute University of Zürich, Winterthurerstrasse 190, CH-8057, Zürich, Switzerland	UZH
Physics Institute, University of Zürich, Winterthurerstrasse 190, CH-8057, Zürich, Switzerland	UZH
Physik Institut der Universität Zürich, Zurich, Switzerland	UZH
Physik Institut, Universität Zürich, Switzerland	UZH
Physik Institut, Universität Zürich, Zürich, CH-8057, Switzerland	UZH
Physik-Institut der Universität Zürich, 8057, Zurich, Switzerland	UZH
Physik-Institut der Universität Zürich, Zurich, Switzerland	UZH
Physik-Institut der Universität Zürich, Zürich, Switzerland	UZH
Physik-Institut, University of Zurich, Zurich, Switzerland	UZH
Physik-Institut, Universität Zürich, 8057, Zurich, Switzerland	UZH
Physik-Institut, Universität Zürich, 8057, Zürich, Switzerland	UZH
Physik-Institut, Universität Zürich, CH-8057, Zürich, Switzerland	UZH
Physik-Institut, Universität Zürich, Winterthurerstr. 190, 8057, Zurich, Switzerland	UZH
Physik-Institut, Universität Zürich, Winterthurerstrasse 190, 8057 Zurich,Switzerland	UZH
Physik-Institut, Universität Zürich, Winterthurerstrasse 190, 8057 Zürich, Switzerland	UZH
Physik-Institut, Universität Zürich, Winterthurerstrasse 190, 8057, Zurich, Switzerland	UZH
Physik-Institut, Universität Zürich, Winterthurerstrasse 190, 8057, Zürich, Switzerland	UZH
Physik-Institut, Universität Zürich, Winterthurerstrasse 190, 8057 , Zurich, Switzerland	UZH
Physik-Institut, Universität Zürich, Winterthurerstrasse 190, CH-8057, Zürich, Switzerland	UZH
Physik-Institut, Universität Zürich, Winterthurerstrasse 190, Zürich, 8057, Switzerland	UZH
Physik-Institut, Universität Zürich, Winterthurerstrasse 190, Zürich, CH-8057, Switzerland	UZH
Physik-Institut, Universität Zürich, Winterthurerstrasse 190, Zürich, Switzerland	UZH
Physik-Institut, Universität Zürich, Wintherturerstrasse 190, CH-8057 Zürich, Switzerland	UZH
Physik-Institut, Universität Zürich, Wintherturerstrasse 190, CH-8057, Zürich, Switzerland	UZH
Physik-Institut, Universität Zürich, Wintherturerstrasse 190, CH-8057 Zürich, Switzerland	UZH
Physik-Institut, Universität Zürich, Zurich, Switzerland	UZH
Physik-Institut, Universität Zürich, Zürich, CH-8057, Switzerland	UZH
Physik-Institut, Universität Zürich, Zürich, Switzerland	UZH
Physikalisches Institut, Universität Basel, Basel, CH-4056, Switzerland	UNIBA
Section de Mathématiques, Université de Genève, Geneva, CH-1211, Switzerland	UNIGE
Section de Physique, Université de Genève,  24 quai E. Ansermet,  Geneva, CH-1211 Switzerland	UNIGE
Section de Physique, Université de Genève,  24 quai E. Ansermet, CH-1211 Geneva, Switzerland	UNIGE
Section de Physique, Université de Genève, Geneva, Switzerland	UNIGE
Section de Physique, Université de Genéve, Geneva, Switzerland	UNIGE
Swiss Institute of Technology ETH-Zürich, 8093 Zürich, Switzerland	ETHZ
Theory Division, CERN,  CH-1211 Geneva 23, Switzerland	CERN
Theory Division, CERN, 1211, Geneva 23, Switzerland	CERN
Theory Division, CERN, CH-1211, Geneva 23, Switzerland	CERN
Theory Division, CERN, Geneva, Switzerland	CERN
Theory Group, Physics Department, CERN, Geneva 23, CH-1211, Switzerland	CERN
University of Bern, Albert Einstein Center for Fundamental Physics, Laboratory for High Energy Physics (LHEP), Bern, Switzerland	UNIBE
University of Bern, Bern, Switzerland	UNIBE
University of Geneva, 1211, Geneva 4, Switzerland	UNIGE
University of Geneva, Department of Theoretical Physics and   Center for Astroparticle Physics (CAP),  24 quai E. Ansermet, CH-1211 Geneva 4, Switzerland	UNIGE
University of Geneva, Geneva, Switzerland	UNIGE
University of Geneva, Section de Physique, DPNC, Geneva, Switzerland	UNIGE
University of Geneva, section de Physique, DPNC, Geneva, Switzerland	UNIGE
Universität Basel, Basel, Switzerland	UNIBA
Universität Bern, Institut für Theoretische Physik, Länggasse, 3012, Bern, Switzerland	UNIBE
Universität Bern, Institut für Theoretische Physik, Sidlerstr. 5, CH-3012, Bern, Switzerland	UNIBE
Universität Zürich, 8006, Zurich, Switzerland	UZH
Universität Zürich, Zurich, Switzerland	UZH
Zurich University, Switzerland	UZH
cole Polytechnique Fdrale de Lausanne (EPFL), Lausanne 1015, Switzerland	EPFL
now at Ecole polytechnique fédérale de Lausanne (EPFL), Lausanne, Switzerland	EPFL
section de Physique, Université de Genève, Geneva, Switzerland	UNIGE
École Polytechnique Fédérale de Lausanne (EPFL), 1015, Lausanne, Switzerland	EPFL
École Polytechnique Fédérale de Lausanne (EPFL), Lausanne, 1015, Switzerland	EPFL
École Polytechnique Fédérale de Lausanne, Lausanne, CH-1015, Switzerland	EPFL
ECOLE POLYTECHNIQUE FEDERALE LAUSANNE LAUSANNE SWITZERLAND	EPFL
ECOLE POLYTECHNIQUE FEDERALE LAUSANNE LAUSANNE CH1015 SWITZERLAND	EPFL
PSI VILLIGEN FORSCHUNGSSTRASSE 111 5232 VILLIGEN PSI SWITZERLAND	PSI
ISDC DATA CENTRE FOR ASTROPHYSICS VERSOIX SWITZERLAND	UNIGE
INSTITUT FUR THEORETISCHE PHYSIK ZURICH UNIVERSITY ZURICH CH8057 SWITZERLAND	UZH
DEPARTMENT OF FUNDAMENTAL MICROBIOLOGY FACULTY OF BIOLOGY AND MEDICINE UNIVERSITY OF LAUSANNE BSP 419 1015 LAUSANNE SWITZERLAND	UNIL
D&#233PARTEMENT DE PHYSIQUE NUCL&#233AIRE ET CORPUSCULAIRE FACULT&#233DE SCIENCES UNIVERSIT&#233 DE GEN&#232VE 1211 GENEVA SWITZERLAND	UNIGE
ASTRONOMY DEPARTMENT UNIVERSITY OF GENEVE CH D&#8217ECOGIA 16 1290 VERSOLX SWITZERLAND	UNIGE
